1 1 1 1 1 1 1 3 4 1 1 1 1 1 1 1
1 1 1 1 1 1 1 3 4 1 1 1 1 1 1 1
1 1 1 1 1 1 1 3 4 1 1 1 1 1 1 1
1 1 1 1 1 1 1 3 4 1 1 1 1 1 1 1
2 2 2 2 2 2 2 2 2 2 2 2 2 2 2 2
0 0 0 0 0 0 0 0 0 0 0 0 0 0 0 0
1 1 1 1 1 1 1 3 4 1 1 1 1 1 1 1
1 1 1 1 1 1 1 3 4 1 1 1 1 1 1 1
1 1 1 1 1 1 1 3 4 1 1 1 1 1 1 1
1 1 1 1 1 1 1 3 4 1 1 1 1 1 1 1
1 1 1 1 1 1 1 3 4 1 1 1 1 1 1 1
1 1 1 1 1 1 1 3 4 1 1 1 1 1 1 1